Size=45
■■■■■■■■■■■■■■■■■■■■■■■■■■■■■■■■■■■■■■■■■■■■■
■□□□□□□□□□□□□□□□□□□□□□□□□□□□□□□□□□□□□□□□□□□□■
■□□□□□□□□□□□□□□□□□□□□□□□□□□□□□□□□□□□□□□□□□□□■
■□□□□□□□□□□□□□□□□□□□□□□□□□□□□□□□□□□□□□□□□□□□■
■□□□□□□□□□□□□□□□□□□□□□□□□□□□□□□□□□□□□□□□□□□□■
■□□□□□□□□□□□□□□□□□□□□□□□□□□□□□■■■■■■■■■■■■■■■
■□□□□□□□□□□□□□□□□□□□□□□□□□□□□□■■■■■■■■■■■■■■■
■□□□□□□□□□□□□□□□□□□□□□□□□□□□□□■■■■■■■■■■■■■■■
■□□□□□□□□□□□□□□□□□□□□□□□□□□□□□■■■■■■■■■■■■■■■
■□□□□□□□□□□□□□□□□□□□□□□□□□□□□□■■■■■■■■■■■■■■■
■□□□□□□□□□□□□□□□□□□□□□□□□□□□□□■■■■■■■■■■■■■■■
■□□□□□□□□□□□□□□□□□□□□□□□□□□□□□□□□□□□□□□□□□□□■
■□□□□□□□□□□□□□□□□□□□□□□□□□□□□□□□□□□□□□□□□□□□■
■□□□□□□□□□□□□□□□□□□□□□□□□□□□□□□□□□□□□□□□□□□□■
■□□□□□□□□□□□□□□□□□□□□□□□□□□□□□□□□□□□□□□□□□□□■
■□□□□□□□□□□□□□□□□□□□□□□□□□□□□□□□□□□□□□□□□□□□■
■□□□□□□□□□□□□□□□□□□□□□□□□□□□□□□□□□□□□□□□□□□□■
■□□□□□□□□□□□□□□□□□□□□□□□□□□□□□□□□□□□□□□□□□□□■
■□□□□□□□□□□□□□□□□□□□□□□□□□□□□□□□□□□□□□□□□□□□■
■□□□□□□□□□□□□□□□□□□□□□□□□■■■■■■■□□□□□□□□□□□□■
■□□□□□□□□□□□□□□□□□□□□□□□□■■■■■■■□□□□□□□□□□□□■
■□□□□□□□□□□□□□□□□□□□□□□□□■■■■■■■□□□□□□□□□□□□■
■□□□□□□□□□□□□□□□□□□□□□□□□■■■■■■■□□□□□□□□□□□□■
■□□□□□□□□□□□□□□□□□□□□□□□□■■■■■■■□□□□□□□□□□□□■
■■■■□□□□□□□□□□□□□□□□□□□□□■■■■■■■□□□□□□□□□□□□■
■■■■□□□□□□□□□□□□□□□□□□□□□■■■■■■■□□□□□□□□□□□□■
■■■■□□□□□□□□□□□□□□□□□□□□□□□□□□□□□□□□□□□□□□□□■
■■■■□□□□□□□□□□□□□□□□□□□□□□□□□□□□□□□□□□□□□□□□■
■■■■□□□□□□□□□□□□□□□□□□□□□□□□□□□□□□□□□□□□□□□□■
■□□□□□□□□□□□□□□□□□□□□□□□□□□□□□□□□□□□□□□□□□□□■
■□□□□□□□□□□□□□□□□□□□□□□□□□□□□□□□□□□□□□□□□□□□■
■□□□□□□□□□□□□□□□□□□□□□□□□□□□□□□□□□□□□□□□□□□□■
■□□□□□□□□□□□□□□□□□□□□□□□□□□□□□□□□□□□□□□□□□□□■
■■■■■■■■■■□□□□□□□□□□□□□□□□□□□□□□□□□□□□□□□□□□■
■■■■■■■■■■□□□□□□□□□□□□□□□□□□□□□□□□□□□□□□□□□□■
■□□□□□□□□□□□□□□□□□□□□□□□□□□□□□□□□□□□□□□□□□□□■
■□□□□□□□□□□□□□□□□□□□□□□□□□□□□□□□□□□□□□□□□□□□■
■□□□□□□□□□□□□□□□□□□□□□□□□□□□□□□□□□□□□□□□□□□□■
■□□□□□□□□□□□□□□□□□□□□□□□□□□□□□□□□□□□□□□□□□□□■
■□□□□□□□□□□□□□□□□□□□□□□□□□□□□□□□□□□□□□□□□□□□■
■□□□□□□□□□□□□□□□□□□□□□□□□□□□□□□□□□□□□□□□□□□□■
■□□□□□□□□□□□□□□□□□□□□□□□□□□□□□□□□□□□□□□□□□□□■
■□□□□□□□□□□□□□□□□□□□□□□□□□□□□□□□□□□□□□□□□□□□■
■□□□□□□□□□□□□□□□□□□□□□□□□□□□□□□□□□□□□□□□□□□□■
■■■■■■■■■■■■■■■■■■■■■■■■■■■■■■■■■■■■■■■■■■■■■
XYPOS=0 0
